11111111111
1P00C00C0C1
1100C00C011
1100C00C011
1100C00C011
10000CE0111
11111111111